{
	"tileset" : "minishcap.png",
	"terrain" : [
		[158, 158, 158, 158, 158, 158, 204, 203, 205, 158, 158, 158, 158, 158, 158, 158, 158, 158, 158, 158, 158, 204, 203, 205, 158,  57, 158,  81,  81,  81],
		[184, 210, 158, 185, 158, 158, 204, 110, 205, 158, 158, 158, 158, 158, 210, 158, 185, 107, 184, 158, 158, 204, 136, 205, 158,  32, 158,  81,  81,  81],
		[185, 158, 158, 158, 158, 158, 204, 203, 205, 107, 158, 158, 158, 158, 158, 158, 158, 184, 158, 158, 184, 204, 203, 205, 158,  57, 158, 158, 158, 158],
		[158, 184, 185, 210, 158, 185, 204, 203, 205, 158, 184, 185, 158, 185, 158, 158, 161, 158, 158, 158, 158, 204, 110, 205, 158,  31,   4,   4,    1,   4],
		[158, 158, 158, 158, 158, 107, 204, 203, 205, 158, 158, 158, 158, 158, 158, 158, 184, 158, 184, 158, 185, 204, 203, 205, 158,  56,  29,  30,  26,  29],
		[158, 158, 158, 158, 158, 158, 204, 203, 205, 185, 158, 158, 158, 107, 185, 158, 158, 185, 158, 158, 158, 204, 203, 205, 107, 158, 158, 158,  87, 158],
		[158, 185, 185, 158, 184, 158, 204, 111, 227, 207, 207, 207, 207, 207, 207, 207, 207, 207, 207, 207, 207, 228, 111, 227, 207, 207, 207, 207, 207, 207],
		[158, 107, 158, 158, 210, 158, 204, 203, 203, 136, 135, 203, 203, 203, 135, 203, 203, 203, 110, 203, 203, 203, 203, 203, 136, 135, 203, 203, 203, 136],
    [158, 158, 158, 185, 158, 158, 280, 208, 208, 208, 208, 208, 208, 208, 208, 208, 208, 208, 208, 208, 208, 208, 208, 208, 208, 208, 208, 208, 208, 208],
    [158, 244, 266, 266, 266, 245, 158, 158, 158, 158, 158, 158, 158, 158, 158, 158, 158, 158, 158, 107, 158, 158, 158, 210, 158, 158, 158, 158, 158, 158],
    [158, 264,  86,  86,  86, 263, 158, 158, 158, 186, 158, 107, 185, 158, 158, 158, 158, 158, 158, 158, 158, 158, 158, 158, 210, 209, 158, 158, 184, 158],
    [184, 264,  86,  86,  86, 263, 107, 185, 184, 185, 185, 184, 185, 158, 158, 158, 158,  81,  81,  81,  81, 158, 158, 185, 185, 158, 158, 158, 107, 158],
    [158, 264,  86,  86,  86, 263, 185, 185, 185, 185, 185, 158, 185, 158, 158, 158, 158,  81,  81,  81,  81, 158, 158, 158, 158, 158, 158, 158, 158, 158],
    [158, 269, 265, 265, 265, 270, 158, 185, 185, 158, 158, 184, 185, 185, 158, 209, 158, 184, 158, 185, 158, 158, 158, 158, 158, 158, 158, 107, 158, 158],
    [158, 210, 107, 158, 185, 184, 158, 158, 158, 158, 158, 158, 186, 185, 158, 158, 158, 158, 185, 158, 158, 158, 184, 158, 158, 184, 158, 185, 158, 158],
    [158, 158, 158, 158, 158, 158, 158, 158, 158, 158, 184, 158, 158, 158, 158, 184, 158, 185, 158, 158, 158, 158, 158, 158, 158, 158, 158, 158, 158, 158],
    [158, 158, 158, 158, 158, 158, 158, 158, 158, 158, 184, 158, 185, 185, 158, 158, 158, 185, 158, 158, 158, 158, 158, 158, 158, 158, 158, 185, 158, 158],
    [ 23,  24,  24,  23,  24,  24,  25, 158, 158, 158, 158, 158, 158, 158, 185, 158, 158, 158, 158, 158, 158, 158, 158, 158, 158, 107, 158, 158, 158, 185],
    [158, 158, 158, 158, 158, 158,  45, 158, 158, 210, 184, 184, 158, 158, 158, 158, 107, 158, 158, 158, 158, 158, 158, 158, 158, 158, 158, 158, 158, 158],
    [158, 158, 158, 158, 158, 158,  70, 158, 107, 158, 184, 184, 184, 158, 185, 158, 158, 158, 210, 158, 158, 158, 158, 158, 158, 158, 158, 158, 185, 158],
    [158, 158, 184, 158, 158, 158,  70, 158, 158, 158, 158, 158, 158, 158, 158, 158, 184, 158, 185, 158, 107, 158, 158, 107, 158, 158, 158, 158, 158, 158],
    [158, 158, 158, 158, 158, 158,  45, 184, 184, 158, 158, 107, 158, 184, 158, 185, 158, 184, 184, 158, 184, 184, 158, 107, 158, 184, 158, 158, 158, 107],
    [158, 158, 210, 158, 107, 158,  70, 184, 184, 158, 185, 158, 158, 184, 158, 158, 158, 107, 158, 185, 184, 185, 158, 158, 158, 158, 184, 158, 184, 158],
    [158, 158, 158, 158, 158, 158,  45, 158, 158, 158, 184, 158, 158, 158, 158, 158, 158, 158, 185, 158, 158, 158, 158, 158, 158, 158, 158, 158, 158, 158],
    [158, 158, 158, 158, 158, 158,  45, 158, 158, 158, 158, 158, 158, 158, 158, 158, 158, 158, 158, 158, 158, 158, 158, 185, 158, 158, 158, 184, 158, 158],
    [  5,   4, 433, 434,   5,   4,  46, 158, 158, 158, 158, 158, 158, 158, 158, 184, 158, 158, 158, 184, 184, 158, 158, 107, 158, 158, 158, 158, 158, 158],
    [ 30,  29, 458, 459,  29,  30,  71, 158, 158, 158, 158, 210, 158, 158, 158, 107, 158, 210, 158, 158, 184, 158, 158, 158, 158, 158, 158, 158, 158, 107],
    [158, 158, 158, 158, 158, 184, 158, 158, 107, 158, 184, 158, 158, 185, 158, 184, 158, 158, 158, 184, 158, 158, 158, 158, 158, 184, 158, 158, 158, 158],
    [158, 158, 158, 158, 158, 184, 158, 158, 158, 184, 184, 158, 158, 158, 158, 158, 158, 184, 158, 158, 158, 107, 158, 158, 158, 185, 158, 184, 184, 158],
    [158, 158, 158, 158, 158, 158, 158, 158, 158, 158, 158, 158, 158, 158, 158, 158, 158, 107, 184, 158, 158, 158, 158, 158, 158, 158, 158, 158, 158, 158]
	],
	"WalkCase" : [
		[ 1, -1, -1, -1, -1, -1, -1, -1, -1, -1, -1, -1, -1, -1, -1, -1, -1, -1, -1, -1, -1, -1, -1, -1, -1,  0,  0, -1, -1,  1],
		[ 1,  1,  1,  1,  1,  1,  1,  1,  1,  1,  1,  1,  1,  1,  1,  1,  1,  1,  1,  1,  1,  1,  1,  1,  1,  0,  0,  1,  1,  1],
		[ 1,  1,  1,  1,  1,  1,  1,  1,  1,  1,  1,  1,  1,  1,  1,  1,  1,  1,  1,  1,  1,  1,  1,  1,  1,  0,  0,  1,  1,  1],
		[ 1, 11, 11, 11,  1,  1,  1,  1,  1,  1,  1,  1,  1,  1,  1,  1,  1,  1,  1,  1,  1,  1,  1,  1,  1,  0,  0,  0,  0,  0],
		[ 1, 11, 11, 11,  1,  1,  1,  1,  1,  1,  1, 10,  1,  1,  1,  1,  1,  1,  1,  1,  1,  1,  1,  1,  1,  0,  0,  0,  0,  0],
		[ 1,  1,  1,  1,  1,  1,  1,  1,  1,  1,  1,  1,  1,  1,  1,  1,  1,  1,  1,  1,  1,  1,  1,  1,  1,  1,  1,  1,  1, -1],
		[ 1,  1,  1,  1,  1,  1,  1,  1,  1,  1,  1,  1,  1,  1,  1,  1,  1,  1,  1,  1,  1,  1,  1,  1,  1,  1,  1,  1,  1, -1],
		[ 1,  1,  1,  1,  1,  1,  1,  1,  1,  1,  1,  1,  1,  1,  1,  1,  1,  1,  1,  1,  1,  1,  1,  1,  1,  1,  1,  1,  1, -1],
		[ 1,  1,  1,  1,  1,  1,  1,  1,  1,  1,  1,  1,  1,  1,  1,  1,  1,  1,  1,  1,  1,  1,  1,  1,  1,  1,  1,  1,  1, -1],
		[ 1,  1,  1,  1,  1,  1,  1,  1,  1,  1,  1,  1,  1,  1,  1,  1,  1,  1,  1,  1,  1,  1,  1,  1,  1,  1,  1,  1,  1, -1],
		[ 1,  1,  2,  2,  2,  1,  1,  1,  1,  1,  1,  1,  1,  1,  1,  1,  0,  0,  1,  1,  0,  0,  1,  1,  1,  0,  0,  1,  1, -1],
		[ 1,  1,  2,  2,  2,  1,  1,  1,  1,  1,  1,  1,  1,  1,  1,  1,  0,  1,  1,  1,  1,  0,  1,  1,  1,  0,  0,  1,  1, -1],
		[ 1,  1,  2,  2,  2,  1,  1,  1,  1,  1,  1,  1,  1,  1,  1,  1,  0,  1,  1,  1,  1,  0,  1,  1,  1,  1,  1,  1,  1, -1],
		[ 1,  1,  1,  1,  1,  1,  1,  1,  1,  1,  1,  1,  1,  1,  1,  1,  0,  0,  0,  0,  0,  0,  1,  1,  1,  1,  1,  1,  1, -1],
		[ 1,  1,  1,  1,  1,  1,  1,  1,  1,  1,  1,  1,  1,  1,  1,  1,  1,  1,  1,  1,  1,  1,  1,  1,  1,  1,  1,  1,  1, -1],
    [ 1,  1,  1,  1,  1,  1,  1,  1,  1,  1,  0,  0,  1,  1,  1,  1,  1,  1,  1,  1,  1,  1,  1,  0,  0,  1,  1,  1,  1, -1],
    [ 1,  1,  1,  1,  1,  1,  1,  1,  1,  1,  0,  0,  1,  1,  1,  1,  1,  1,  1,  1,  1,  1,  1,  0,  0,  1,  1,  1,  1, -1],
    [ 0,  0,  0,  0,  0,  0,  0,  1,  1,  1,  1,  1,  1,  1,  1,  1,  1,  1,  1,  1,  1,  1,  1,  1,  1,  1,  1,  1,  1, -1],
    [ 0,  0,  0,  0,  0,  0,  0,  1,  1,  1,  1,  0,  0,  0,  0,  0,  0,  0,  0,  0,  0,  0,  0,  0,  0,  1,  1,  1,  1, -1],
    [ 1,  1,  1,  1,  1,  0,  0,  1,  1,  1,  1,  0,  1,  1,  1,  1,  1,  1,  1,  1,  1,  1,  1,  1,  0,  1,  1,  1,  1, -1],
    [ 1,  1,  1,  1,  1,  0,  0,  1,  1,  1,  1,  0,  1, -1, -1,  1,  1,  1,  1,  1,  1,  1,  1,  1,  0,  1,  1,  1,  1, -1],
    [ 1,  1,  1,  1,  1,  0,  0,  1,  1,  1,  1,  0,  1,  0,  0,  1,  1,  1,  1,  1,  1,  1,  1,  1,  0,  1,  1,  1,  1, -1],
    [ 1,  1,  1,  1,  1,  0,  0,  1,  1,  1,  1,  0,  1,  1,  1,  1,  1,  1,  1,  1,  1,  1,  1,  1,  0,  1,  1,  1,  1, -1],
    [ 1,  1,  1,  1,  1,  0,  0,  1,  1,  1,  1,  0,  1,  1,  1,  1,  1,  1,  1,  1,  1,  1,  1,  1,  0,  1,  1,  1,  1, -1],
    [ 0,  0,  1,  1,  0,  0,  0,  1,  1,  1,  1,  0,  1,  1,  1,  1,  1,  1,  1,  1,  1,  1,  1,  1,  0,  1,  1,  1,  1, -1],
    [ 0,  0,  1,  1,  0,  0,  0,  1,  1,  1,  1,  0,  0,  0,  0,  0,  0,  1,  1,  0,  0,  0,  0,  0,  0,  1,  1,  1,  1, -1],
    [ 0,  0,  1,  1,  0,  0,  0,  1,  1,  1,  1,  1,  1,  1,  1,  1,  1,  1,  1,  1,  1,  1,  1,  1,  1,  1,  1,  1,  1, -1],
    [ 1,  1,  1,  1,  1,  1,  1,  1,  1,  1,  1,  1,  1,  1,  1,  1,  1,  1,  1,  1,  1,  1,  1,  1,  1,  1,  1,  1,  1, -1],
    [ 1,  1,  1,  1,  1,  1,  1,  1,  1,  1,  1,  1,  1,  1,  1,  1,  1,  1,  1,  1,  1,  1,  1,  1,  1,  1,  1,  1,  1, -1],
    [ 1,  1,  1,  1,  1,  1,  1,  1,  1,  1,  1,  1,  1,  1,  1,  1,  1,  1,  1,  1,  1,  1,  1,  1,  1,  1,  1,  1,  1,  1]
	],
  "decoration" : [
    [  0,   0,   0,   0,   0,   0,   0,   0,   0,   0,   0,   0,   0,   0,   0,   0,   0,   0,   0,   0,   0,   0,   0,   0,   0,   0,  52, 108, 108, 108],
    [  0,   0,   0,   0,   0,   0,   0,   0,   0,   0,   0,   0,  77,  77,   0,   0,   0,   0,   0,  77,  77,   0,   0,   0,   0,   0, 358, 108, 108, 108],
    [  0,   0,   0,   0,   0,   0,   0,   0,   0,   0,   0,  77,   0,   0,   0,   0,   0,   0,   0,  77,  77,   0,   0,   0,   0,   0,  54,  55,  52,  53],
    [  0, 454, 455, 456,   0,   0,   0,   0,   0,   0,   0,   0,   0,   0,   0,   0,   0,   0,   0,   0,   0,   0,   0,   0,   0,   0,   0,   0,  0,   0],
    [  0, 479, 480, 481,   0,   0,   0,   0,   0,   0,   0,  83,   0,   0,   0,   0,  77,  77,   0,   0,   0,   0,   0,   0,   0,   0,   0,   0,  0,   0],
    [  0,   0,   0,   0,   0,   0,   0,   0,   0,   0,   0,   0,   0,   0,   0,   0,   0,   0,   0,   0,   0,   0,   0,   0,   0,   0,   0,   0,  0,   0],
    [  0,   0,   0,   0,   0,   0,   0,   0,   0,   0,   0,   0,   0,   0,   0,   0,   0,   0,   0,   0,   0,   0,   0,   0,   0,   0,   0,   0,  0,   0],
    [  0,   0,   0,   0,   0,   0,   0,   0,   0,   0,   0,   0,   0,   0,   0,   0,   0,   0,   0,   0,   0,   0,   0,   0,   0,   0,   0,   0,  0,   0],
    [  0,   0,   0,   0,   0,   0,   0,   0,   0,   0,   0,   0,   0,   0,   0,   0,   0,   0,   0,   0,   0,   0,   0,   0,   0,   0,   0,   0,  0,   0],
    [  0,   0,   0,   0,   0,   0,   0,   0,   0,   0,   0,   0,   0,   0,   0,   0,   0,   0,   0,   0,   0,   0,   0,   0,   0,   0,   0,   0,  0,   0],
    [  0,   0,   0,   0,   0,   0,   0,   0,   0,  77,   0,   0,   0,  77,   0,   0, 212, 213,   0,   0, 212, 213,   0,   0,   0, 162, 163,   0,  0,   0],
    [  0,   0,   0,   0,   0,   0,   0,   0,   0,   0,  77,   0,   0,  77,   0,   0, 418, 108, 108, 108, 108, 237,   0,  77,   0, 187, 188,   0,  0,   0],
    [  0,   0,   0,   0,   0,   0,   0,   0,  77,   0,  77,  77,  77,  77,   0,   0, 417, 108, 108, 108, 108, 238,   0,   0,   0,   0,   0,   0,  0,   0],
    [  0,   0,   0,   0,   0,   0,   0,  77,  77,  77,   0,   0,   0,   0,   0,   0, 212, 392, 393, 392, 393, 213,   0,   0,   0,   0,  77,   0,  0,   0],
    [  0,   0,   0,   0,   0,   0,   0,   0,   0,   0,   0,   0,   0,   0,   0,   0,   0,   0,   0,   0,   0,   0,   0,   0,   0,   0,   0,   0,  0,   0],
    [  0,   0,   0,   0,   0,   0,   0,   0,   0,   0, 162, 163,   0,   0,   0,  77,  77,  77,  77,   0,   0,   0,   0, 162, 163,   0,   0,   0,  0,   0],
    [  0,   0,   0,   0,   0,   0,   0,   0,   0,   0, 187, 188,   0,   0,   0,   0,  77,  77,  77,  77,  77,   0,   0, 187, 188,   0,   0,   0,  77,  0],
    [  0,   0,   0,   0,   0,   0,   0,   0,   0,   0,   0,   0,   0,   0,   0,   0,   0,   0,   0,   0,   0,   0,   0,   0,   0,   0,   0,   0,  77,  0],
    [120, 121, 118, 120, 283, 308,   0,   0,   0,   0,   0, 212, 392, 393, 392, 393, 392, 393, 392, 393, 392, 393, 392, 393, 213,   0,   0,   0,  0,   0],
    [  0,   0,   0,   0,   0, 358,   0,   0,   0,   0,   0, 418,   0,   0,   0,   0,   0,   0,   0,   0,   0,   0,   0,   0, 237,   0,   0,   0,  0,   0],
    [  0,   0,   2,   2,   0, 333,   0,   0,   0,   0,   0, 417,   0, 306, 307,   0,   0,  77,  77,   0,   0,   0,   0,   0, 238,   0,   0,   0,  0,   0],
    [  0,   0,   0,   0,   0, 119,   0,   0,   0,   0,   0, 418,   0, 331, 332,   0,   0,   0,   0,  77,   0,   0,   0,   0, 237,   0,   0,  77,  77,  0],
    [  0,   0,   0,   0,   0, 118,   0,   0,   0,   0,   0, 417,   0,   0,   0,   0,   0,   0,   0,   0,   0,   0,  77,   0, 238,   0,   0,   0,  77,  0],
    [  0,   0,   0,   0,   0, 117,   0,   0,   0,   0,   0, 418,   0,   0,   0,   0,  77,  77,   0,   0,   0,   0,  77,   0, 237,   0,   0,   0,  0,   0],
    [ 52,  53,   0,   0,  54,  55,   0,   0,   0,   0,   0, 417,   0,   0,   0,   0,   0,   0,   0,   0,   0,   0,   0,   0, 238,   0,   0,   0,  0,   0],
    [  0,   0,   0,   0,   0,   0,   0,   0,   0,   0,   0, 212, 392, 393, 392, 393, 213,   0,   0, 212, 392, 393, 392, 393, 213,   0,   0,  77,  0,   0],
    [  0,   0,   0,   0,   0,   0,   0,   0,   0,   0,   0,   0,   0,   0,   0,   0,   0,   0,   0,   0,   0,   0,   0,   0,   0,   0,   0,  77,  0,   0],
    [  0,   0,   0,   0,   0,   0,   0,   0,   0,   0,   0,  77,   0,   0,   0,   0,   0,   0,   0,   0,  77,   0,  77,   0,   0,   0,   0,   0,  0,   0],
    [  0,   0,   0,   0,  77,   0,   0,   0,   0,   0,   0,   0,  77,  77,   0,   0,   0,   0,   0,   0,  77,   0,   0,   0,   0,   0,   0,  77,  0,   0],
    [  0,   0,   0,  77,  77,  77,   0,   0,   0,   0,   0,   0,   0,   0,   0,   0,   0,   0,  77,  77,  77,   0,   0,   0,   0,   0,   0,   0,  0,   0]
  ]
}
