{
  "tileset" : "minishcap.png",
  "terrain" : [
    [158, 158, 158, 158, 158, 158, 158, 158, 158, 158, 158, 158, 158, 87, 158, 158, 158, 158, 158, 158, 158, 158, 158, 158, 158, 158, 158, 158, 158, 158],
    [  4,   3,   5,   5,   5,   4,   5,   4,   4,   5,   5,   5,   5,   1,   5,   4,   4,   5,   4,   5,   4,   5,   5,   3,   4,   5,   4,   5,   4,   4],
    [ 29,  28,  29,  30,  30,  30,  30,  30,  29,  29,  30,  30,  29,  26,  29,  30,  30,  29,  29,  29,  30,  29,  30,  28,  29,  30,  30,  30,  29,  30],
    [158, 158, 158, 158, 158, 158, 158, 158, 158, 158, 158, 158,  90, 141,  91, 158, 158, 112, 113, 114, 158, 158, 158, 158, 184, 158, 158, 158, 158, 158],
    [158, 158, 185, 158, 158, 158, 158, 158, 158, 158, 184, 158, 165, 151, 166, 158, 158, 137, 138, 139, 158, 158, 158, 107, 158, 184, 158, 158, 158, 158],
    [158, 107, 184, 158, 158, 158, 184, 107, 184, 158, 158,  90,  61,  86, 166, 158, 158, 158, 158, 184, 158, 158, 158, 158, 184, 158, 158, 158, 158, 158],
    [158, 158, 158, 158, 158, 158, 158, 158, 185, 158, 158, 165, 251, 101, 166, 158, 158, 185, 185, 185, 107, 183, 207, 207, 207, 207, 207, 207, 207, 207],
    [158, 158, 158, 158, 158, 158, 158, 161, 158, 192, 141,  61, 201,  86, 166, 158, 158, 158, 158, 158, 158, 204, 203, 203, 203, 203, 203, 203, 203, 203],
    [158, 158, 158, 158, 184, 158, 184, 158, 158, 165, 191, 194, 195, 195, 218, 158, 158, 158, 158, 184, 158, 204, 203, 102, 208, 208, 208, 208, 208, 208],
    [107, 158, 158, 158, 158, 185, 158, 158, 192,  61, 166, 158, 158, 161, 158, 158, 158, 185, 107, 158, 158, 204, 203, 205, 158, 107,  82, 161, 107, 158],
    [158, 158, 158, 158, 158, 158, 158,  90,  61, 101, 218, 158, 185, 158, 158, 184, 158, 185, 158, 158, 158, 204, 203, 205, 158, 185, 158, 158, 158, 158],
    [158, 158, 158, 158, 158, 158,  90,  61, 191, 218, 158, 184, 158, 158, 158, 184, 158, 158, 158, 158, 161, 204, 203, 205, 158, 185, 184, 158, 158, 158],
    [158, 161, 185, 158,  90, 140, 151, 191, 218, 158, 158, 158, 158, 158, 158, 158, 158, 158, 158, 158, 185, 204, 203, 205, 158, 158, 184, 158, 185, 158],
    [140, 141, 140, 141,  61, 251,  86, 166, 185, 158, 158, 184, 158, 158, 185, 158, 158, 158, 158, 158, 158, 204, 203, 205, 158, 158, 184, 161, 158, 158],
    [101,  86,  86, 201, 151, 176, 191, 218, 184, 158, 158, 158, 158, 185, 185, 107, 158, 158, 185, 158, 158, 204, 203, 205, 158, 158, 158, 184, 184, 158],
    [201, 151, 101,  86, 251, 191, 218, 158, 158, 107, 158, 185, 158, 158, 158, 107, 158, 184, 158, 185, 158, 204, 203, 205, 184, 158, 185, 185, 184, 158],
    [151, 201,  86, 251, 191, 218, 158, 158, 161, 158, 158, 185,  82, 158, 158, 184, 184, 184, 184, 158, 185, 204, 203, 205, 184, 158, 158, 158, 158, 158],
    [194, 195, 194, 195, 218, 158, 158, 158, 158, 158, 158, 158, 158, 158, 158, 158, 158, 158, 158, 158, 158, 204, 203, 205, 184, 158, 161, 107, 158, 158],
    [158, 158, 158, 158, 158, 158, 158, 158, 158, 158, 158, 158, 158, 185, 185, 158, 185, 158, 158, 107, 184, 204, 203, 205, 158, 158, 107, 158, 158, 158],
    [158, 158, 158, 158, 158, 158, 158, 158, 158, 158, 158, 158, 158, 158, 185, 158, 158, 158, 158, 158, 158, 204, 203, 205, 158, 185, 185, 158, 158, 158],
    [158, 158, 158, 158, 158, 158, 183, 207, 207, 207, 207, 207, 207, 207, 207, 207, 207, 207, 207, 207, 207, 228, 203, 205, 158, 185, 184, 184, 158, 158],
    [158, 158, 158, 158, 158, 158, 204, 203, 203, 203, 203, 203, 203, 203, 203, 203, 203, 203, 203, 203, 203, 203, 203, 205, 158, 158, 158, 158, 158, 158],
    [158, 158, 158, 184, 158, 158, 204, 203, 102, 208, 208, 208, 208, 208, 208, 208, 208, 208, 208, 208, 208, 103, 203, 205, 158,  22,  24,  24,  23,  24],
    [158, 158, 158, 158, 107, 184, 204, 203, 205, 158, 158, 158, 158, 158, 161, 158, 185, 158, 158, 158, 158, 204, 203, 205, 158,  57, 158, 158, 158, 158],
    [158, 158, 158, 158, 107, 185, 204, 203, 205, 158, 158, 185, 185, 158, 184, 158, 158, 158, 185, 158, 158, 204, 203, 205, 158,  32, 158,  81,  81,  81],
    [161, 158, 158, 158, 185, 158, 204, 203, 205, 158, 158, 158, 158, 158, 184, 158, 107, 158, 184, 158, 158, 204, 203, 205, 158,  32, 158,  81,  81,  81],
    [158, 158, 107, 158, 158, 158, 204, 203, 205, 158, 158, 158, 158, 158, 158, 158, 185, 158, 185, 158, 158, 204, 203, 205, 158,  57, 158,  81,  81,  81],
    [158, 158, 158, 158, 158, 158, 204, 203, 205, 158, 158, 184, 161, 158, 158, 158, 158, 184, 184, 158, 185, 204, 203, 205, 158,  32, 158,  81,  81,  81],
    [158, 158, 158, 158, 158, 184, 204, 203, 205, 158, 158, 107, 158,  82, 158, 158, 158, 158, 158, 107, 158, 204, 203, 205, 158,  32, 158,  81,  81,  81],
    [184, 158, 158, 158, 158, 158, 204, 203, 205, 158, 158, 158, 158, 158, 158, 158, 158, 158, 158, 158, 184, 204, 203, 205, 158,  57, 158,  81,  81,  81]
  ],
  "WalkCase" : [
    [ 0,  0,  0,  0,  0,  0,  0,  0,  0,  0,  0,  0,  0,  0,  0,  0,  0,  0,  0,  0,  0,  0,  0,  0,  0,  0,  0,  0,  0,  0],
    [ 0,  0,  0,  0,  0,  0,  0,  0,  0,  0,  0,  0,  0,  0,  0,  0,  0,  0,  0,  0,  0,  0,  0,  0,  0,  0,  0,  0,  0,  0],
    [ 0,  0,  0,  0,  0,  0,  0,  0,  0,  0,  0,  0,  0,  0,  0,  0,  0,  0,  0,  0,  0,  0,  0,  0,  0,  0,  0,  0,  0,  0],
    [ 1,  1,  1,  0,  0,  0,  0,  0,  1,  1,  1,  1,  0,  0,  0,  1,  1,  1, -1,  1,  1,  1,  1,  1,  1,  1,  1,  1,  1, -1],
    [ 1,  1,  1,  0,  0,  0,  0,  0,  1,  1,  1,  1,  0,  0,  0,  1,  1,  1,  1,  1,  1,  1,  1,  1,  1,  1,  1,  1,  1, -1],
    [ 1,  1,  1,  0,  0,  0,  0,  0,  1,  1,  1,  0,  0,  0,  0,  1,  1,  1,  1,  1,  1,  1,  1,  1,  1,  1,  1,  1,  1, -1],
    [ 1,  1,  1,  0,  0,  0,  0,  0,  1,  1,  1,  0,  0,  0,  0,  1,  1,  1,  1,  1,  1,  1,  1,  1,  1,  1,  1,  1,  1, -1],
    [ 1,  1,  1,  0,  0,  0,  0,  0,  1,  0,  0,  0,  0,  0,  0,  1,  1,  1,  1,  1,  1,  1,  1,  1,  1,  1,  1,  1,  1, -1],
    [ 1,  1,  1,  1,  1, -1,  1,  1,  1,  0,  0,  0,  0,  0,  0,  1,  1,  1,  1,  1,  1,  1,  1,  1,  1,  1,  1,  1,  1, -1],
    [ 1,  1,  1,  1,  1,  1,  1,  1,  0,  0,  0,  1,  1,  1,  1,  1,  1,  1,  1,  1,  1,  1,  1,  1,  1,  1,  1,  1,  1, -1],
    [ 1,  1,  1,  1,  1,  1,  1,  0,  0,  0,  0,  1,  0,  0,  0,  0,  0,  1,  1,  1,  1,  1,  1,  1,  1,  1,  1,  1,  1, -1],
    [ 1,  1,  1,  1,  1,  1,  0,  0,  0,  0,  1,  1,  0,  0,  0,  0,  0,  1,  1,  1,  1,  1,  1,  1,  1,  1,  1,  1,  1, -1],
    [ 1,  1,  1,  1,  0,  0,  0,  0,  0,  1,  1,  1,  0,  0,  0,  0,  0,  1,  1,  1,  1,  1,  1,  1,  1,  1,  1,  1,  1, -1],
    [ 0,  1,  0,  0,  0,  0,  0,  0,  1,  1,  1,  1,  0,  0,  0,  0,  0,  1,  1,  1,  1,  1,  1,  1,  1,  1,  1,  1,  1, -1],
    [ 0,  1,  0,  0,  0,  0,  0,  0,  1,  1,  1,  1,  0,  0,  0,  0,  0,  1,  1,  1,  1,  1,  1,  1,  1,  1,  1,  1,  1, -1],
    [ 0,  1,  0,  0,  0,  0,  0,  1,  1,  1,  1,  1,  1,  1, -1,  1,  1,  1,  1,  1,  1,  1,  1,  1,  1,  1,  1,  1,  1, -1],
    [ 0,  1,  0,  0,  0,  0,  1,  1,  1,  1,  1,  1,  1,  1,  1,  1,  1,  1,  1,  1,  1,  1,  1,  1,  1,  1,  1,  1,  1, -1],
    [ 0,  1,  0,  0,  0,  1,  1,  1,  1,  1,  1,  1,  1,  1,  1,  1,  1,  1,  1,  1,  1,  1,  1,  1,  1,  1,  1,  1,  1, -1],
    [ 1,  1,  1,  1,  1,  1,  1,  1,  1,  1,  1,  1,  1,  1,  1,  1,  1,  1,  1,  1,  1,  1,  1,  1,  1,  1,  1,  1,  1, -1],
    [ 1,  1,  1,  1,  1,  1,  1,  1,  1,  1,  1,  1, 10,  1,  1,  1,  1,  1,  1,  1,  1,  1,  1,  1,  1,  1,  1,  1,  1, -1],
    [ 1,  1,  1,  1,  1,  1,  1,  1,  1,  1,  1,  1,  1,  1,  1,  1,  1,  1,  1,  1,  1,  1,  1,  1,  1,  1,  1,  1,  1, -1],
    [ 1,  1,  1,  1,  1,  1,  1,  1,  1,  1,  1,  1,  1,  1,  1,  1,  1,  1,  1,  1,  1,  1,  1,  1,  1,  1,  1,  1,  1, -1],
    [ 1,  1,  1,  1,  1,  1,  1,  1,  1,  1,  1,  1,  1,  1,  1,  1,  1,  1,  1,  1,  1,  1,  1,  1,  1,  0,  0,  0,  0,  0],
    [ 1,  1,  1,  1,  1,  1,  1,  1,  1,  1,  1,  1,  1,  1,  1,  1,  1,  1,  1,  1,  1,  1,  1,  1,  1,  0,  0,  0,  0,  0],
    [ 1,  1,  1,  1,  1,  1,  1,  1,  1,  1,  1,  1,  1,  1,  1,  1,  1,  1,  1,  1,  1,  1,  1,  1,  1,  0,  0,  1,  1, -1],
    [ 1,  1,  1,  1,  1,  1,  1,  1,  1,  1,  1,  1,  1,  1,  1,  0,  1,  1,  1,  1,  1,  1,  1,  1,  1,  0,  0,  1,  1, -1],
    [ 1,  1,  1,  1,  1,  1,  1,  1,  1,  1,  1,  1,  1,  1,  1,  1,  1,  1,  1,  1,  1,  1,  1,  1,  1,  0,  0,  1,  1, -1],
    [ 1,  1,  1,  1,  1,  1,  1,  1,  1,  1,  1,  1,  1,  1,  1,  1,  1,  1,  1,  1,  1,  1,  1,  1,  1,  0,  0,  1,  1, -1],
    [ 1,  1,  1,  1,  1,  1,  1,  1,  1,  1,  1,  1,  1,  1,  1,  1,  1,  1,  1,  1,  1,  1,  1,  1,  1,  0,  0,  1,  1, -1],
    [-1, -1, -1, -1, -1, -1, -1, -1, -1, -1, -1, -1, -1, -1, -1, -1, -1, -1, -1, -1, -1, -1, -1, -1,  1,  0,  0, -1, -1,  1]
  ],
  "decoration" : [
    [117, 119, 120, 121, 120, 118, 120, 119, 333, 117, 120, 120, 121,   0, 120, 119, 119, 120, 119, 121, 333, 120, 119, 120, 333, 120, 118, 120, 118, 119],
    [  0,   0,   0,   0,   0,   0,   0,   0,   0,   0,   0,   0,   0,   0,   0,   0,   0, 482, 483, 484,   0,   0,   0,   0,   0,   0,   0,   0,   0,   0],
    [  0,   0,   0,   0,   0,   0,   0,   0,   0,   0,   0,   0,   0,   0,   0,   0,   0, 507, 508, 509,   0,   0,   0,   0,   0,   0,   0,   0,   0,   0],
    [  0,   0,   0, 296, 297, 298, 299, 300,   0,   0,   0,   0,   0,   0,   0,   0,   0,   0,   0,   0,   0,   0,   0,   0,   0,   0,   0,  77,   0,   0],
    [  0,  77,   0, 321, 322, 323, 324, 325,   0,  77,  77,   0,   0,   0,   0,   0,   0,   0,   0,   0,   0,   0,   0,   0,   0,   0,   0,  77,   0,   0],
    [  0,  77,   0, 346, 347, 348, 349, 350,   0,   0,   0,   0,   0,   0,   0,   0,   0,   0,   0,  77,   0,   0,   0,   0,   0,   0,   0,   0,   0,   0],
    [  0,   0,   0, 371, 372, 373, 374, 375,   0,   0,   0,   0,   0,   0,   0,   0,   0,   0,  77,  77,  77,   0,   0,   0,   0,   0,   0,   0,   0,   0],
    [  0,   0,   0, 396, 397, 398, 399, 400,   0,   0,   0,   0,   0,   0,   0,   0,   0,   0,   0,  77,   0,   0,   0,   0,   0,   0,   0,   0,   0,   0],
    [  0,   0,   0, 421, 422, 423, 424, 425,   0,   0,   0,   0,   0,   0,   0,   0,   0,   0,   0,   0,   0,   0,   0,   0,   0,   0,   0,   0,   0,   0],
    [  0,  77,   0,   0,   0,   0,   0,   0,   0,   0,   0,   0,   0,   0,   0,   0,   0,   0,   0,   0,   0,   0,   0,   0,   0,   0,   0,   0,   0,   0],
    [  0,   0,   0,  77,  77,   0,   0,   0,   0,   0,   0,   0, 196, 197, 198, 199, 200,   0,   0,   0,   0,   0,   0,   0,   0,   0,   0,   0,   0,   0],
    [  0,   0,   0,  77,   0,   0,   0,   0,   0,   0,   0,   0, 221, 222, 223, 224, 225,   0,   0,   0,   0,   0,   0,   0,   0,   0,   0,   0,   0,   0],
    [  0, 352,   0,   0,   0,   0,   0,   0,   0,   0,   0,   0, 246, 247, 248, 249, 250,   0,   0,   0,   0,   0,   0,   0,   0,   0,   0,   0,  77,   0],
    [  0, 326,   0,   0,   0,   0,   0,   0,   0,   0,   0,   0, 271, 272, 273, 274, 275,   0,   0,   0,   0,   0,   0,   0,   0,  77,   0,  77,  77,   0],
    [  0, 326,   0,   0,   0,   0,   0,   0,   0,   0,   0,   0, 396, 397, 398, 399, 400,   0,  77,  77,   0,   0,   0,   0,   0,  77,   0,   0,  77,   0],
    [  0, 326,   0,   0,   0,   0,   0,   0,   0,   0,   0,   0, 421, 422, 423, 424, 425,   0,   0,  77,   0,   0,   0,   0,   0,  77,   0,   0,  77,   0],
    [  0, 326,   0,   0,   0,   0,   0,   0,  77,  77,  77,   0,   0,   0,   0,   0,   0,   0,   0,   0,   0,   0,   0,   0,   0,  77,   0,  77,  77,   0],
    [  0, 326,   0,   0,   0,   0,  77,   0,   0,   0,   0,   0,   0,   0,   0,   0,   0,   0,   0,   0,   0,   0,   0,   0,   0,   0,   0,   0,   0,   0],
    [  0, 351,   0,   0,   0,   0,  77,  77,   0,   0,  77,   0,   0,   0,   0,   0,   0,   0,   0,   0,   0,   0,   0,   0,   0,   0,   0,   0,   0,   0],
    [  0,   0,   0,   0,   0,   0,   0,   0,   0,   0,   0,   0,  83,   0,   0,   0,   0,   0,   0,   0,   0,   0,   0,   0,   0,   0,   0,   0,   0,   0],
    [  0,  77,  77,   0,   0,   0,   0,   0,   0,   0,   0,   0,   0,   0,   0,   0,   0,   0,   0,   0,   0,   0,   0,   0,   0,   0,   0,  77,   0,   0],
    [  0,   0,   0,   0,   0,   0,   0,   0,   0,   0,   0,   0,   0,   0,   0,   0,   0,   0,   0,   0,   0,   0,   0,   0,   0,   0,   0,   0,   0,   0],
    [  0,   0,   0,   0,   0,   0,   0,   0,   0,   0,   0,   0,   0,   0,   0,   0,   0,   0,   0,   0,   0,   0,   0,   0,   0,   0,   0,   0,   0,   0],
    [  0,  77,   0,   0,   0,   0,   0,   0,   0,   0,   0,   0,   0,   0,   0,   0,   0,   0,   0,   0,   0,   0,   0,   0,   0,   0, 333, 117, 120, 118],
    [  0,   0,   0,   0,   0,   0,   0,   0,   0,   0,   0,  77,   0,   0,   0,   0,   0,   0,   0,   0,   0,   0,   0,   0,   0,   0, 121, 108, 108, 108],
    [  0,   0,   0,  77,   0,   0,   0,   0,   0,   0,   0,   0,   0,   0,   0,  84,   0,   0,   0,  77,   0,   0,   0,   0,   0,   0, 358, 108, 108, 108],
    [  0,   0,   0,  77,   0,   0,   0,   0,   0,   0,  77,   0,   0,   0,   0,   0,   0,   0,   0,  77,   0,   0,   0,   0,   0,   0, 119, 108, 108, 108],
    [  0,   0,   0,   0,   0,   0,   0,   0,   0,   0,   0,   0,   0,   0,   0,   0,   0,   0,   0,  77,   0,   0,   0,   0,   0,   0, 117, 108, 108, 108],
    [  0,   0,   0,   0,   0,   0,   0,   0,   0,   0,   0,   0,   0,  77,  77,   0,   0,   0,  77,  77,   0,   0,   0,   0,   0,   0, 358, 108, 108, 108],
    [  0,   0,   0,   0,   0,   0,   0,   0,   0,   0,   0,   0,   0,  77,   0,   0,   0,   0,  77,   0,   0,   0,   0,   0,   0,   0,  52, 108, 108, 108]
  ]
}