{
  "tileset" : "minishcap.png",
  "terrain" : [
    [ 45, 158, 158, 158, 158, 158, 204, 203, 205, 158,  16,  17, 101,  86,  86, 226,  80,   8,   9, 158, 158, 158, 158, 158, 158, 158, 158, 184, 158, 158],
    [ 70, 158, 209, 158, 158, 158, 204, 203, 205, 158,  41,  42,  86, 251, 226,  86, 251,  33,  34, 158, 158, 158, 158, 158, 158, 158, 158, 158, 107, 158],
    [ 45, 107, 161, 158, 158, 158, 204, 203, 205, 158,  66,  67, 276,  86, 151,  86, 251,   8,  59, 158, 158, 158, 107, 158, 107, 185, 158, 158, 158, 158],
    [ 46, 158, 158, 158, 158, 209, 204, 203, 205, 158,  41,  67, 226,  86,  80, 101,  86,  58,  34, 158, 158, 158, 158, 185, 158, 185, 158, 210, 185, 158],
    [ 71, 185, 185, 158, 158, 209, 204, 203, 205, 158,  41,  17, 226, 101,  86, 251,  86,  58,  59, 158, 210, 158, 158, 158, 158, 158, 158, 158, 158, 158],
    [158, 158, 185, 209, 158, 158, 204, 203, 205, 158,  16,  42, 176,  86, 226,  86, 226,   8,   9, 158, 185, 158, 184, 158, 158, 158, 158, 158, 158, 158],
    [207, 207, 207, 207, 207, 207, 228, 203, 205, 158,  16,  42, 104, 101, 126, 151, 101,  33,   9, 158, 158, 158, 158, 158, 158, 158, 184, 185, 107, 158],
    [203, 203, 203, 203, 203, 203, 203, 203, 205, 158,  66,  67, 151,  86, 176,  86,  80,  33,  34, 158, 158, 158, 158, 158, 158, 158, 185, 158, 158, 158],
    [208, 208, 208, 208, 208, 208, 208, 208, 279, 158,  66,  17, 104, 226, 151, 251, 151,   8,   9, 158, 158, 185, 158, 107, 185, 158, 158, 158, 158, 158],
    [158, 158, 158, 184, 158, 158, 158, 158, 184, 158,  41,  17, 226, 101,  86,  86,  86,  58,  59, 158, 158, 158, 158, 184, 158, 158, 158, 158, 158, 158],
    [158, 210, 185, 158, 158, 210, 158, 158, 107, 158,  16,  42,  86, 176, 226,  86, 101,  33,  59, 158, 158, 158, 158, 158, 158, 158, 185, 158, 158, 158],
    [158, 185, 185, 158, 158, 161, 158, 185, 158, 158,  41,  17, 151, 276,  80, 226, 251,   8,   9, 158, 158, 158, 185, 158, 158, 158, 107, 158, 185, 107],
    [158, 185, 158, 184, 158, 185, 158, 158, 158, 158,  41,  67, 101, 226, 101,  86, 251,   8,  34, 158, 158, 158, 158, 158, 210, 158, 158, 185, 158, 158],
    [158, 107, 158, 158, 107, 158, 158, 185, 209, 158,  66,  42, 176, 104,  79, 101,  86,  58,  34, 158, 158, 158, 107, 158, 158, 158, 158, 158, 158, 158],
    [158, 158, 209, 158, 185, 184, 158, 210, 161, 158,  16,  17, 126,  86, 251,  86,  80,  33,   9, 158, 158, 185, 158, 184, 158, 158, 158, 185, 158, 158],
    [158, 184, 158, 158, 158, 185, 158, 158, 158, 158,  66,  42,  86,  86,  86, 251,  86,  33,  34, 158, 158, 158, 107, 158, 185, 185, 158, 158, 185, 158],
    [158, 158, 158, 158, 158, 158, 158, 158, 158, 107,  16,  42,  86, 104, 226,  86, 251,  58,   9, 158, 158, 158, 158, 158, 158, 158, 158, 158, 158, 158],
    [185, 185, 158, 158, 185, 210, 158, 158, 185, 158,  41,  17, 101,  86, 226, 251,  86,   8,  59, 158,  22,  23,  23,  24,  23,  24,  23,  24,  24,  23],
    [107, 158, 158, 158, 184, 185, 158, 158, 158, 158,  41,  67,  86,  86,  86, 151, 101,  33,  59, 158,  57, 158, 158, 158, 158, 158, 158, 158, 158, 158],
    [158, 158, 158, 185, 158, 158, 158, 158, 158, 158,  66,  17,  86,  86, 104,  86,  86,   8,   9, 158,  32, 158, 158, 158, 158, 158, 158, 158, 158, 158],
    [185, 158, 158, 158, 107, 158, 158, 158, 185, 107,  16,  67, 151,  86, 251,  86, 151,   8,   9, 158,  57, 158, 158, 158, 184, 158, 158, 158, 158, 158],
    [158, 158, 158, 158, 185, 158, 185, 158, 158, 158,  16,  42, 251, 101,  86, 251,  86,  58,  34, 158,  32, 158, 158, 158, 158, 107, 158, 185, 158, 158],
    [158, 107, 184, 158, 158, 158, 158, 158, 158, 158,  66,  17, 251,  80,  86,  80, 226,  33,   9, 158,  32, 158, 158, 107, 158, 158, 158, 184, 158, 158],
    [158, 185, 210, 158, 158, 185, 158, 185, 158, 158,  66,  17,  86,  86, 151,  86, 101,  33,  34, 158,  57, 158, 158, 185, 158, 158, 158, 185, 158, 158],
    [158, 158, 158, 158, 185, 210, 185, 158, 158, 184,  41,  42,  86, 251,  86,  86,  80,  58,  59, 158,  32, 158, 158, 158, 158, 210, 158, 158, 158, 158],
    [158, 158, 158, 185, 158, 185, 158, 185, 158, 158,  16,  67,  86,  86, 104, 151, 251,   8,  34, 210,  32, 107, 158, 158, 158, 158, 158, 185, 158, 158],
    [158, 158, 158, 158, 184, 158, 107, 158, 158, 185,  41,  42, 226,  86, 251, 101, 226,  58,  59, 158,  32, 158, 158, 158, 158, 158, 158, 158, 107, 158],
    [158, 158, 185, 158, 185, 185, 185, 158, 158, 158,  66,  42,  86,  86,  86,  86, 101,   8,   9, 158,  57, 158, 158, 185, 158, 107, 158, 158, 158, 158],
    [185, 158, 158, 107, 158, 184, 158, 185, 158, 158,  16,  17,  86, 151, 226, 101,  80,  58,  34, 158,  57, 158, 158, 158, 158, 158, 158, 158, 158, 158],
    [107, 158, 158, 158, 158, 185, 158, 158, 158, 158,  16,  67, 104,  86,  80, 251,  86,  33,  34, 158,  32, 158, 158, 158, 185, 158, 158, 210, 158, 158]
  ],
  "WalkCase" : [
    [ 0,  0,  0,  0,  0,  0, -1, -1, -1,  0,  0,  0,  0,  0,  0,  0,  0,  0,  0,  0, -1, -1, -1, -1, -1, -1, -1, -1, -1,  1],
    [ 0,  0,  0,  0,  0,  0,  1,  1,  1,  0,  0,  0,  0,  0,  0,  0,  0,  0,  0,  0,  1,  1,  1,  1,  1,  1,  1,  1,  1, -1],
    [ 0,  0,  0,  0,  0,  0,  1,  1,  1,  0,  0,  0,  0,  0,  0,  0,  0,  0,  0,  0,  1,  1,  1,  1,  1,  1,  1,  1,  1, -1],
    [ 0,  0,  0,  0,  0,  0,  1,  1,  1,  0,  0,  0,  0,  0,  0,  0,  0,  0,  0,  0,  1,  1,  1,  1,  1,  1,  1,  1,  1, -1],
    [ 0,  1,  1, -1,  1,  1,  1,  1,  1,  1,  1,  1,  1,  1,  1,  1,  1,  1,  1,  1,  1,  1,  1,  1,  1,  1,  1,  1,  1, -1],
    [-1,  1,  1,  1,  1,  1,  1,  1,  1,  0,  0,  0,  0,  0,  0,  0,  0,  0,  0,  0,  1,  1,  1,  1,  1,  1,  1,  1,  1, -1],
    [-1,  1,  1,  1,  1,  1,  1,  1,  1,  0,  0,  0,  0,  0,  0,  0,  0,  0,  0,  0,  1,  1,  1,  1,  1,  0,  1,  1,  1, -1],
    [-1,  1,  1,  1,  1,  1,  1,  1,  1,  0,  0,  0,  0,  0,  0,  0,  0,  0,  0,  0,  1,  1, 10,  1,  1,  1,  1,  1,  1, -1],
    [-1,  1,  1,  1,  1,  1,  1,  1,  1,  0,  0,  0,  0,  0,  0,  0,  0,  0,  0,  0,  1,  1,  1,  1,  1,  1,  1,  1,  1, -1],
    [-1,  1,  1,  0,  1,  1,  1,  1,  1,  0,  0,  0,  0,  0,  0,  0,  0,  0,  0,  0,  1,  1,  1,  1,  1,  1,  1,  1,  1, -1],
    [-1,  1,  1,  1,  1,  1,  1,  1,  1,  0,  0,  0,  0,  0,  0,  0,  0,  0,  0,  0,  1,  1,  1,  1,  1,  1,  1,  1,  1, -1],
    [-1,  1,  1,  1,  1,  1,  1,  1,  1,  0,  0,  0,  0,  0,  0,  0,  0,  0,  0,  0,  1,  1,  1,  1,  1,  1,  1,  1,  1, -1],
    [-1,  1,  1,  1,  1,  1,  1,  1,  1,  0,  0,  0,  0,  0,  0,  0,  0,  0,  0,  0,  1,  1,  1,  0,  1,  1,  1,  1,  1, -1],
    [-1,  1,  1,  1,  1,  1,  1,  1,  1,  0,  0,  0,  0,  0,  0,  0,  0,  0,  0,  0,  1,  1,  1,  1,  1,  1,  1,  1,  1, -1],
    [-1,  1,  1,  1,  1,  1,  1,  1,  1,  0,  0,  0,  0,  0,  0,  0,  0,  0,  0,  0,  1,  1,  1,  1,  1,  1,  1,  1,  1, -1],
    [-1,  1,  1,  1,  1,  1,  1,  1,  1,  0,  0,  0,  0,  0,  0,  0,  0,  0,  0,  0,  1,  1,  1,  1,  1,  1,  1,  1,  1, -1],
    [-1,  1,  1,  1,  1,  0,  1,  1,  1,  0,  0,  0,  0,  0,  0,  0,  0,  0,  0,  0,  1,  1,  1,  1,  1,  1,  1,  1,  1, -1],
    [-1,  1,  1,  1,  1,  1,  1,  1,  1,  0,  0,  0,  0,  0,  0,  0,  0,  0,  0,  1,  0,  0,  0,  0,  0,  0,  0,  0,  0,  0],
    [-1,  1, 10,  1,  1,  1,  1,  1,  1,  0,  0,  0,  0,  0,  0,  0,  0,  0,  0,  1,  0,  0,  0,  0,  0,  0,  0,  0,  0,  0],
    [-1,  1,  1,  1,  1,  1,  1,  1,  1,  0,  0,  0,  0,  0,  0,  0,  0,  0,  0,  1,  0,  0,  1,  1,  1,  1,  1,  1,  1, -1],
    [-1,  1,  1,  1,  1,  1,  1,  1,  1,  0,  0,  0,  0,  0,  0,  0,  0,  0,  0,  1,  0,  0,  1,  1,  1,  1,  1,  1,  1, -1],
    [-1,  1,  1,  1,  1,  1,  1,  1,  1,  0,  0,  0,  0,  0,  0,  0,  0,  0,  0,  1,  0,  0,  1,  1,  1,  1,  1,  1,  1, -1],
    [-1,  1,  1,  1,  1,  1,  1,  1,  1,  0,  0,  0,  0,  0,  0,  0,  0,  0,  0,  1,  0,  0,  1,  1,  1,  1,  1,  0,  0, -1],
    [-1,  1,  1,  1,  1,  1,  1,  1,  1,  0,  0,  0,  0,  0,  0,  0,  0,  0,  0,  1,  0,  0,  1,  1,  1,  1,  1,  0,  0, -1],
    [-1,  1,  0,  0,  0,  1,  1,  1,  1,  0,  0,  0,  0,  0,  0,  0,  0,  0,  0,  1,  0,  0,  1,  1,  1,  1,  1,  1,  1, -1],
    [-1,  1,  0,  0,  0,  1,  1,  1,  1,  0,  0,  0,  0,  0,  0,  0,  0,  0,  0,  1,  0,  0,  1,  1,  1,  1,  1,  1,  1, -1],
    [-1,  1,  0,  0,  0,  1,  1,  1,  1,  0,  0,  0,  0,  0,  0,  0,  0,  0,  0,  1,  0,  0,  1,  1,  1,  1,  1,  1,  1, -1],
    [-1,  1,  0,  0,  0,  1,  1,  1,  1,  0,  0,  0,  0,  0,  0,  0,  0,  0,  0,  1,  0,  0,  1,  1,  1,  1,  1,  1,  1, -1],
    [-1,  1,  1,  1,  1,  1,  1,  1,  1,  0,  0,  0,  0,  0,  0,  0,  0,  0,  0,  1,  0,  0,  1,  1,  1,  1,  1,  1,  1, -1],
    [ 1,  1,  1,  1,  1,  1,  1,  1,  1,  0,  0,  0,  0,  0,  0,  0,  0,  0,  0,  1,  0,  0,  1,  1,  1,  1,  1,  1,  1,  1]
  ],
  "decoration" : [
    [0, 435, 436, 437, 438, 439,   0,   0,  0, 117,   0,   0,   0,   0,   0,   0,   0,   0,   0, 121,   0,   0,   0,   0,   0,   0,   0,   0,   0,   0],
    [0, 460, 461, 462, 463, 464,   0,   0,  0,  92,   0,   0,   0,   0,   0,   0,   0,   0,   0, 117,   0,   0,  77,   0,   0,   0,   0,  77,   0,   0],
    [0, 485, 486, 487, 488, 489,   0,   0,  0, 119,   0,   0,   0,   0,   0,   0,   0,   0,   0, 358,   0,   0,   0,  77,   0,   0,  77,   0,   0,   0],
    [0, 510, 511, 512, 513, 514,   0,   0,  0, 333,   0,   0,   0,   0,   0,   0,   0,   0,   0, 119,   0,   0,   0,   0,   0,   0,  77,   0,   0,   0],
    [0, 535, 536, 537, 538, 539,   0,   0,  0, 177, 178, 178, 178, 178, 178, 178, 178, 178, 178, 202,   0,   0,   0,   0,   0,   0,   0,   0,   0,   0],
    [0,   0,   0,   0,   0,   0,   0,   0,  0, 358,   0,   0,   0,   0,   0,   0,   0,   0,   0, 333,   0,   0,   0,   0,   0,   0,   0,   0,   0,   0],
    [0,   0,   0,   0,   0,   0,   0,   0,  0, 119,   0,   0,   0,   0,   0,   0,   0,   0,   0, 121,   0,   0,   0,   0,   0, 118,   0,   0,   0,   0],
    [0,   0,   0,   0,   0,   0,   0,   0,  0, 308,   0,   0,   0,   0,   0,   0,   0,   0,   0,  92,   0,   0,  83,   0,   0,   0,  77,   0,   0,   0],
    [0,   0,   0,   0,   0,   0,   0,   0,  0, 117,   0,   0,   0,   0,   0,   0,   0,   0,   0, 333,   0,   0,   0,  77,  77,   0,  77,   0,   0,   0],
    [0,   0,   0, 119,   0,   0,   0,   0,  0, 358,   0,   0,   0,   0,   0,   0,   0,   0,   0, 358,   0,   0,   0,   0,   0,   0,  77,  77,   0,   0],
    [0,   0,   0,   0,   0,   0,   0,   0,  0, 118,   0,   0,   0,   0,   0,   0,   0,   0,   0, 358,   0,   0,  77,   0,   0,   0,  77,   0,   0,   0],
    [0,   0,   0,   0,   0,  77,   0,   0,  0, 358,   0,   0,   0,   0,   0,   0,   0,   0,   0, 119,   0,   0,   0,   0,   0,   0,   0,   0,   0,   0],
    [0,   0,   0,   0,  77,  77,   0,   0,  0, 117,   0,   0,   0,   0,   0,   0,   0,   0,   0, 358,   0,   0,   0, 117,   0,   0,   0,   0,   0,   0],
    [0,   0,  77,  77,   0,   0,   0,  77,  0, 308,   0,   0,   0,   0,   0,   0,   0,   0,   0, 118,   0,   0,   0,   0,  82,   0,   0,   0,   0,   0],
    [0,   0,   0,   0,   0,   0,   0,  77,  0, 358,   0,   0,   0,   0,   0,   0,   0,   0,   0, 358,   0,   0,   0,   0,   0,   0,   0,   0,   0,   0],
    [0,   0,   0,   0,   0,   0,   0,   0,  0, 358,   0,   0,   0,   0,   0,   0,   0,   0,   0, 121,   0,   0,   0,   0,   0,   0,   0,   0,   0,   0],
    [0,   0,   0,   0,   0,  83,   0,   0,  0,  92,   0,   0,   0,   0,   0,   0,   0,   0,   0, 333,   0,   0,   0,   0,   0,   0,   0,   0,   0,   0],
    [0,   0,   0,   0,   0,   0,   0,   0,  0, 121,   0,   0,   0,   0,   0,   0,   0,   0,   0,   0,   0,   0,   0,   0,   0,   0,   0,   0,   0,   0],
    [0,   0,  84,   0,   0,   0,   0,   0,  0, 117,   0,   0,   0,   0,   0,   0,   0,   0,   0,   0,   0,  92, 333,  92, 120, 117, 118, 120, 119, 333],
    [0,   0,   0,   0,  77,   0,   0,   0,  0, 333,   0,   0,   0,   0,   0,   0,   0,   0,   0,   0,   0,  92,   0,   0,   0,   0,   0,   0,   0,   0],
    [0,   0,   0,  77,   0,  77,   0,   0,  0, 358,   0,   0,   0,   0,   0,   0,   0,   0,   0,   0,   0, 358,   0, 108, 108, 108, 108,   0,   0,   0],
    [0,   0,   0,   0,  77,   0,   0,   0,  0, 121,   0,   0,   0,   0,   0,   0,   0,   0,   0,   0,   0, 119,   0, 108, 108, 108,   0,   0,   0,   0],
    [0,   0,   0,   0,   0,   0,   0,   0,  0,  92,   0,   0,   0,   0,   0,   0,   0,   0,   0,   0,   0, 358,   0, 108, 108, 108,   0, 306, 307,   0],
    [0,   0,   0,   0,   0,   0,   0,   0,  0, 118,   0,   0,   0,   0,   0,   0,   0,   0,   0,   0,   0, 119,   0, 108,   0,   0,   0, 331, 332,   0],
    [0,   0, 426, 427, 428,   0,   0,   0,  0, 119,   0,   0,   0,   0,   0,   0,   0,   0,   0,   0,   0, 117,   0,   0,   0,   0,   0,   0,   0,   0],
    [0,   0, 451, 452, 453,   0,   0,   0,  0, 117,   0,   0,   0,   0,   0,   0,   0,   0,   0,   0,   0,  92,   0,   0,   0,  77,   0,   0,   0,   0],
    [0,   0, 476, 477, 478,   0,   0,   0,  0, 358,   0,   0,   0,   0,   0,   0,   0,   0,   0,   0,   0, 308,   0,   0,  77,   0,   0,   0,   0,   0],
    [0,   0, 501, 502, 503,   0,   0,   0,  0, 333,   0,   0,   0,   0,   0,   0,   0,   0,   0,   0,   0, 117,   0,   0,   0,  77,  77,   0,   0,   0],
    [0,   0,   0,   0,   0,   0,   0,   0,  0,  92,   0,   0,   0,   0,   0,   0,   0,   0,   0,   0,   0, 358,   0,   0,   0,   0,   0,   0,   0,   0],
    [0,   0,   0,   0,   0,   0,   0,   0,  0, 119,   0,   0,   0,   0,   0,   0,   0,   0,   0,   0,   0, 118,   0,   0,   0,   0,   0,   0,   0,   0]
  ]
}